b,b,b,b,b,b,b,b,b,b,b
b,l,e,e,e,p,e,e,e,b,b
b,e,1,b,e,e,e,b,2,u,b
b,e,b,b,e,b,e,b,b,e,b
b,e,e,e,s,b,e,e,e,e,b
b,p,e,b,b,b,b,b,e,p,b
b,e,e,e,e,b,g,e,e,e,b
b,e,b,b,e,b,e,b,b,e,b
b,u,4,b,e,e,e,b,3,e,b
b,b,e,e,e,p,e,e,e,l,b
b,b,b,b,b,b,b,b,b,b,b
