b,b,b,b,b,b,b,b,b,b,b
b,l,e,e,e,e,e,b,b,b,b
b,b,b,b,e,b,e,e,e,b,b
b,b,b,b,e,b,b,b,e,b,b
b,s,e,1,e,3,b,2,e,g,b
b,b,b,b,e,b,b,b,e,b,b
b,b,b,b,e,b,e,e,e,b,b
b,l,e,e,e,e,e,b,b,b,b
b,b,b,b,b,b,b,b,b,b,b
