b,b,b,b,b,b,b,b,b,b,b
b,o,e,e,w,e,e,l,b,4,b
b,e,b,b,e,e,b,w,w,w,b
b,e,b,2,e,b,b,p,b,b,b
b,e,e,e,e,l,q,e,e,g,b
b,e,b,b,b,e,p,e,b,b,b
b,e,e,e,e,e,n,e,b,3,b
b,b,b,e,b,b,b,e,b,e,b
b,s,e,e,q,1,b,u,q,e,b
b,b,b,b,b,b,b,b,b,b,b
