b,b,b,b,b,b,b,b,b,b,b,b
b,x,e,e,b,e,e,e,b,b,b,b
b,e,b,e,e,e,b,e,u,e,e,b
b,e,b,b,e,b,x,b,e,b,e,b
b,e,e,e,g,e,e,e,l,p,e,b
b,e,b,b,e,b,e,b,x,b,e,b
b,u,e,e,e,e,e,e,e,e,e,b
b,b,e,b,b,e,b,b,b,b,b,b
b,s,e,b,x,e,e,e,e,e,l,b
b,b,b,b,b,b,b,b,b,b,b,b